0 0 25 25 25 25 25 25 25 25 25 25 25 25 25 25 0 0
26 26 26 26 26 26 26 26 26 26 26 26 26 26 26 26 26 26
27 27 27 27 27 27 27 27 27 27 27 27 27 27 27 27 27 27
21 21 21 21 21 21 21 21 21 21 21 21 21 21 21 21 21 21
27 27 27 27 27 27 27 27 27 27 27 27 27 27 27 27 27 27
26 26 26 26 26 26 26 26 26 26 26 26 26 26 26 26 26 26
0 0 25 25 25 25 25 25 25 25 25 25 25 25 25 25 0 0
21 21 21 21 21 21 21 21 21 21 21 21 21 21 21 21 21 21
